*******************************************************************************************
*******************************************************************************************
*******************************************************************************************
*******************************************************************************************
**###########******************************************************************************
**#.........#******************************************************************************
**#....@....#****##############*********##############*************************************
**#.........######............#********#..............#************************************
**#...........................#*******#................#****################***************
**################............########.................######...............#****########**
*****************#..........................................................#####.......#**
*****************#............#######..................#####............................#**
*****************#............#*******#................#****##..............#####.......#**
*****************#............#********#..............#*******#########.....#****########**
*****************##############*********#############******************#####***************
*******************************************************************************************
*******************************************************************************************